Lord of the Rings
An Interactive Fiction by Josh Laptop
Release 1 / Serial number 181126 / Inform 7 build 6M62 (I6/v6.33 lib 6/12N) SD

Feast Room
You see a warm fire burning in the hearth. There is a table with some left over food from the feast. A window lets the Sun in from outside. The front door to the north, leads outside.

You see a small jewel encrusted chest.

Gandalf has arrived and stares at you imposingly.

Aragorn has arrived and is ready to go.

Bormor snickers at you and the ring.

>ask gandalf about ring
Gandalf says: "Frodo, it is a very dangerous ring, we must dispose of it immediately."

>ask aragorn
What do you want to ask Aragorn for?

>talk to aragorn
You can't see any such thing.

>speak aragorn
Whom do you want to speak that to?

>talk to gandalf
You can't see any such thing.

>speak to gandalf
I didn't understand that sentence.

* * *

>ask gandalf about ring
Gandalf says: "Frodo, it is a very dangerous ring, we must dispose of it immediately."

>ask gandalf about the ring
There is no reply.

* * *

Lord of the Rings
An Interactive Fiction by Josh Laptop
Release 1 / Serial number 181126 / Inform 7 build 6M62 (I6/v6.33 lib 6/12N) SD

Feast Room
You see a warm fire burning in the hearth. There is a table with some left over food from the feast. A window lets the Sun in from outside. The front door to the north, leads outside.

You see a small jewel encrusted chest.

Gandalf has arrived and stares at you imposingly.

Aragorn has arrived and is ready to go.

Bormor snickers at you and the ring.

>ask gandalf about the ring
Gandalf says: "Frodo, it is a very dangerous ring, we must dispose of it immediately."

>ask gandalf about ring
Gandalf says: "Frodo, it is a very dangerous ring, we must dispose of it immediately."

* * *

Lord of the Rings
An Interactive Fiction by Josh Laptop
Release 1 / Serial number 181126 / Inform 7 build 6M62 (I6/v6.33 lib 6/12N) SD

Feast Room
You see a warm fire burning in the hearth. There is a table with some left over food from the feast. A window lets the Sun in from outside. The front door to the north, leads outside.

You see a small jewel encrusted chest.

Gandalf has arrived and stares at you imposingly.

Aragorn has arrived and is ready to go.

Bormor snickers at you and the ring.

>look
Frodo's house
You see a warm fire burning in the hearth. There is a table with some half eaten food on it. A window lets the Sun in from outside. The front door to the north, leads outside.

You see a small jewel encrusted chest.

>open chest
You open the small jewel chest, revealing a ring.

>take ring
Taken.

>look at ring
It's gold and shiny, so shiny you can't help being captivated by its beauty...

>throw ring into fire
You throw the ring into the fire! After a time, you notice it has not burned... but some writing has appeared on it. You use some fire tongs to remove the rings...

>inventory
You are carrying:
  a ring

>look at the ring
The gold and shiny ring has revealed some strang writing...

* * *

Lord of the Rings
An Interactive Fiction by Josh Laptop
Release 1 / Serial number 181126 / Inform 7 build 6M62 (I6/v6.33 lib 6/12N) SD

Feast Room
You see a warm fire burning in the hearth. There is a table with some left over food from the feast. A window lets the Sun in from outside. The front door to the north, leads outside.

You see a small jewel encrusted chest.

Gandalf has arrived and stares at you imposingly.

Aragorn has arrived and is ready to go.

Bormor snickers at you and the ring.

>look aragorn
Also known as Strider, he is heir to the throne of Gondor will help you travel to Mordor to destroy the ring.

* * *

Lord of the Rings
An Interactive Fiction by Josh Laptop
Release 1 / Serial number 181126 / Inform 7 build 6M62 (I6/v6.33 lib 6/12N) SD

Feast Room
You see a warm fire burning in the hearth. There is a table with some left over food from the feast. A window lets the Sun in from outside. The front door to the north, leads outside.

You see a small jewel encrusted chest.

Gandalf has arrived and stares at you imposingly.

Aragorn has arrived and is ready to go.

Bormor snickers at you and the ring.

>look at Gandalf
He is a wizard, member of the Istari order. He is very tall and wears a large grey pointy hat and has a wooden staff.

>talk to gandalf
That's not a verb I recognise.

>ask gandalf about the ring
There is no reply.

>hi
That's not a verb I recognise.

* * *

Lord of the Rings
An Interactive Fiction by Josh Laptop
Release 1 / Serial number 181126 / Inform 7 build 6M62 (I6/v6.33 lib 6/12N) SD

Feast Room
You see a warm fire burning in the hearth. There is a table with some left over food from the feast. A window lets the Sun in from outside. The front door to the north, leads outside.

You see a small jewel encrusted chest.

Gandalf has arrived and stares at you imposingly.

Aragorn has arrived and is ready to go.

Bormor snickers at you and the ring.

>look at chest
It has a golden latch on the front, it looks easy to open.

>open chest
It isn't something you can open.

* * *

>look at chest
It has a golden latch on the front, it looks easy to open.

>take ring
You can't see any such thing.

>ope nchest
That's not a verb I recognise.

>open chest
You open the small jewel chest, revealing a ring.

* * *

>take ring
Taken.

>inventory
You are carrying:
  a ring

>n
shire
The sun is shining and you can hear birds in the trees. South is Frodo's house. To the west is a river.

>drop
(the ring)
Dropped.

>look
shire
The sun is shining and you can hear birds in the trees. South is Frodo's house. To the west is a river.

You can see a ring here.

>s
Frodo's house
You see a warm fire burning in the hearth. There is a table with some half eaten food on it. A window lets the Sun in from outside. The front door to the north, leads outside.

You see a small jewel encrusted chest.

>look at ring
You can't see any such thing.

* * *

>take ring
You can't see any such thing.

>put right in chest
You can't see any such thing.

>look
Frodo's house
You see a warm fire burning in the hearth. There is a table with some half eaten food on it. A window lets the Sun in from outside. The front door to the north, leads outside.

You see a small jewel encrusted chest.

>take ring
You already have that.

>put ring in chest
You put the ring into the small jewel chest.

* * *

Lord of the Rings
An Interactive Fiction by Josh Laptop
Release 1 / Serial number 181126 / Inform 7 build 6M62 (I6/v6.33 lib 6/12N) SD

Feast Room
You see a warm fire burning in the hearth. There is a table with some left over food from the feast. A window lets the Sun in from outside. The front door to the north, leads outside.

You see a small jewel encrusted chest.

Gandalf has arrived and stares at you imposingly.

Aragorn has arrived and is ready to go.

Bormor snickers at you and the ring.

>look at fire
The fire burns brightly, giving off a comforting warmth.

>look at fireplace
The fire burns brightly, giving off a comforting warmth.

>look at hearth
The fire burns brightly, giving off a comforting warmth.

>take hearth
That's hardly portable.

>take fire
That's hardly portable.

* * *

>look at fire
The fire burns brightly, giving off a comforting warmth.

>look at hearth
You see nothing special about the hearth.

>look hearth
You see nothing special about the hearth.

* * *

Lord of the Rings
An Interactive Fiction by Josh Laptop
Release 1 / Serial number 181126 / Inform 7 build 6M62 (I6/v6.33 lib 6/12N) SD

Feast Room
You see a warm fire burning in the hearth. There is a table with some left over food from the feast. A window lets the Sun in from outside. The front door to the north, leads outside.

You see a small jewel encrusted chest.

Gandalf has arrived and stares at you imposingly.

Aragorn has arrived and is ready to go.

Bormor snickers at you and the ring.

>look at hearth
The fire burns brightly, giving off a comforting warmth.

>look at fire
You can't see any such thing.

* * *

Lord of the Rings
An Interactive Fiction by Josh Laptop
Release 1 / Serial number 181126 / Inform 7 build 6M62 (I6/v6.33 lib 6/12N) SD

Feast Room
You see a warm fire burning in the hearth. There is a table with some left over food from the feast. A window lets the Sun in from outside. The front door to the north, leads outside.

You see a small jewel encrusted chest.

Gandalf has arrived and stares at you imposingly.

Aragorn has arrived and is ready to go.

Bormor snickers at you and the ring.

>loook at table
That's not a verb I recognise.

>look at table
The food on the table has been there awhile, and has gone bad...

>examine table
The food on the table has been there awhile, and has gone bad...

>look at the food
Some slightly hardened cheese, and crusty stale bread. It doesn't look very edible...

>take table
That's hardly portable.

>look at chest
You see nothing special about the small jewel chest.

* * *

Lord of the Rings
An Interactive Fiction by Josh Laptop
Release 1 / Serial number 181126 / Inform 7 build 6M62 (I6/v6.33 lib 6/12N) SD

Feast Room
You see a warm fire burning in the hearth. There is a table with some left over food from the feast. A window lets the Sun in from outside. The front door to the north, leads outside.

You see a small jewel encrusted chest.

Gandalf has arrived and stares at you imposingly.

Aragorn has arrived and is ready to go.

Bormor snickers at you and the ring.

>n
Rivendell
Rivendell, also known as Imladris, is an Elven town and the house of Elrond.

* * *

Lord of the Rings
An Interactive Fiction by Josh Laptop
Release 1 / Serial number 181126 / Inform 7 build 6M62 (I6/v6.33 lib 6/12N) SD

Feast Room
You see a warm fire burning in the hearth. There is a table with some left over food from the feast. A window lets the Sun in from outside. The front door to the north, leads outside.

You see a small jewel encrusted chest.

Gandalf has arrived and stares at you imposingly.

Aragorn has arrived and is ready to go.

Bormor snickers at you and the ring.

>north
shire
The sun is shining and you can hear birds in the trees.

* * *

Lord of the Rings
An Interactive Fiction by Josh Laptop
Release 1 / Serial number 181126 / Inform 7 build 6M62 (I6/v6.33 lib 6/12N) SD

Feast Room
You see a warm fire burning in the hearth. There is a table with some left over food from the feast. A window lets the Sun in from outside. The front door to the north, leads outside.

You see a small jewel encrusted chest.

Gandalf has arrived and stares at you imposingly.

Aragorn has arrived and is ready to go.

Bormor snickers at you and the ring.

>open chest
You open the small jewel chest, revealing a ring.

>look at ring
It's gold and shiny, so shiny you can't help being captivated by its beauty...

>put chest on table
(first taking the small jewel chest)
You put the small jewel chest on the table.

>look at table
The food on the table has been there awhile, and has gone bad...

On the table is a small jewel chest (in which is a ring).

>throw the ring into the fire
(first taking the ring)
That can't contain things.

* * *

>take ring
Taken.

>throw ring into fire
You throw the ring into the fire! After a time, you notice it has not burned... but some writing has appeared on it. You use some fire tongs to remove the rings...

* * *

>inventory
You are carrying:
  a ring

>look at ring
It's gold and shiny, so shiny you can't help being captivated by its beauty...

* * *

>open chest
You open the small jewel chest, revealing a ring.

>throw ring into fire
You throw the ring into the fire! After a time, you notice it has not burned... but some writing has appeared on it. You use some fire tongs to remove the rings...

>inventory
You are carrying nothing.

>look at hearth
The fire burns brightly, giving off a comforting warmth.

* * *

>throw ring into fire
You throw the ring into the fire! After a time, you notice it has not burned... but some writing has appeared on it. You use some fire tongs to remove the rings...

>put right
You can't see any such thing.

>put ring in fire
You throw the ring into the fire!

* * *

Lord of the Rings
An Interactive Fiction by Josh Laptop
Release 1 / Serial number 181126 / Inform 7 build 6M62 (I6/v6.33 lib 6/12N) SD

Feast Room
You see a warm fire burning in the hearth. There is a table with some left over food from the feast. A window lets the Sun in from outside. The front door to the north, leads outside.

You see a small jewel encrusted chest.

Gandalf has arrived and stares at you imposingly.

Aragorn has arrived and is ready to go.

Bormor snickers at you and the ring.

>open the chest
You open the small jewel chest, revealing a ring.

>throw the ring into the fire
(first taking the ring)
You put the ring into the hearth.

>put the chest in the fire
(first taking the small jewel chest)
You put the small jewel chest into the hearth.

* * *

Lord of the Rings
An Interactive Fiction by Josh Laptop
Release 1 / Serial number 181126 / Inform 7 build 6M62 (I6/v6.33 lib 6/12N) SD

Feast Room
You see a warm fire burning in the hearth. There is a table with some left over food from the feast. A window lets the Sun in from outside. The front door to the north, leads outside.

You see a small jewel encrusted chest.

Gandalf has arrived and stares at you imposingly.

Aragorn has arrived and is ready to go.

Bormor snickers at you and the ring.

>take fire
You'll burn your hands!

* * *

Lord of the Rings
An Interactive Fiction by Josh Laptop
Release 1 / Serial number 181126 / Inform 7 build 6M62 (I6/v6.33 lib 6/12N) SD

Feast Room
You see a warm fire burning in the hearth. There is a table with some left over food from the feast. A window lets the Sun in from outside. The front door to the north, leads outside.

You see a small jewel encrusted chest.

Gandalf has arrived and stares at you imposingly.

Aragorn has arrived and is ready to go.

Bormor snickers at you and the ring.

>take the chest
Taken.

>chest
That's not a verb I recognise.

>grab chest
That's not a verb I recognise.

>touch chest
You feel nothing unexpected.

>take chest
You already have that.

>inventory
You are carrying:
  a small jewel chest

>drop chest
Dropped.

>look
Frodo's house
You see a warm fire burning in the hearth. There is a table with some half eaten food on it. A window lets the Sun in from outside. The front door to the north, leads outside.

You can see a small jewel chest here.

>s
You can't go that way.

>n
shire
The sun is shining and you can hear birds in the trees. South is Frodo's house. To the west is a river.

>pick up chest
You can't see any such thing.

>s
Frodo's house
You see a warm fire burning in the hearth. There is a table with some half eaten food on it. A window lets the Sun in from outside. The front door to the north, leads outside.

You can see a small jewel chest here.

>look at fire
You can't see any such thing.

* * *

Lord of the Rings
An Interactive Fiction by Josh Laptop
Release 1 / Serial number 181126 / Inform 7 build 6M62 (I6/v6.33 lib 6/12N) SD

Feast Room
You see a warm fire burning in the hearth. There is a table with some left over food from the feast. A window lets the Sun in from outside. The front door to the north, leads outside.

You see a small jewel encrusted chest.

Gandalf has arrived and stares at you imposingly.

Aragorn has arrived and is ready to go.

Bormor snickers at you and the ring.

>take the hearth
Taken.

>inventory
You are carrying:
  a hearth

* * *

Lord of the Rings
An Interactive Fiction by Josh Laptop
Release 1 / Serial number 181126 / Inform 7 build 6M62 (I6/v6.33 lib 6/12N) SD

Feast Room
You see a warm fire burning in the hearth. There is a table with some left over food from the feast. A window lets the Sun in from outside. The front door to the north, leads outside.

You see a small jewel encrusted chest.

Gandalf has arrived and stares at you imposingly.

Aragorn has arrived and is ready to go.

Bormor snickers at you and the ring.

>throw chest into fire
You don't want to burn that!

>inventory
You are carrying nothing.

>look
Frodo's house
You see a warm fire burning in the hearth. There is a table with some half eaten food on it. A window lets the Sun in from outside. The front door to the north, leads outside.

You see a small jewel encrusted chest.

>take chest
Taken.

>throw chest into the fire
You don't want to burn that!

>inventory
You are carrying:
  a small jewel chest (closed)

>open chest
You open the small jewel chest, revealing a ring.

* * *

>throw ring into fire
You throw the ring into the fire! After a time, you notice it has not burned... but some writing has appeared on it. You use some fire tongs to remove the rings...

>inventory
You are carrying:
  a small jewel chest (open)
    a ring

>look at ring
It's gold and shiny, so shiny you can't help being captivated by its beauty...